TURN	T ER N
THE	DH AH
THE(2)	DH IY
LIGHT	L AY T
OFF	AO F
ON	AA N
ON(2)	AO N
MOVE	M UW V
FORWARD	F AO R W ER D
BACKWARD	B AE K W ER D
LEFT	L EH F T
RIGHT	R AY T
STROBE	S T R OW B
MODE	M OW D
DRIVING	D R AY V IH NG
WALKING	W AO K IH NG
CONVERT	K AA N V ER T
CONVERT(2)	K AH N V ER T
TO	T UW
TO(2)	T IH
TO(3)	T AH